##############################
#0000000000000000000000000000#
#0000000000000000000000000000#
#0000000000000000000000000000#
#0000000000000000000000000000#
#0000000000000000000000000000#
#0000000000000000000000000000#
#0000000000000000000000000000#
#0000000000000000000#######00#
#0000000000000000000#00000#00#
#0000000000000000000#00000#00#
#0000000000000000000#00000#00#
#0000000000000000000#######00#
#0000000000000000000000000000#
#0000000000000000000000000000#
#0000000000000000000000000000#
#0000000000000000000000000000#
#0000000000000000000000000000#
#0000000000000000000000000000#
##############################