65
36
TYYYYYYYYYYYYYYYYYYYYYYYYYYYYYYYYYYYYYYYYYYYYYYYYYYYYYYYYYYYYYYYU
G000000000000000000000000000000000000000000000000000000000000000J
G000000000000000000000000000000000000000000000000000000000000000J
G000000000000000000000000000000000000000000000000000000000000000J
G000000000000000000000000000000000000000000000000000000000000000J
G000000000000000000000000000000000000000000000000000000000000000J
G000000000000000000000000000000000000000000000000000000000000000J
G000000000000000000000000000000000000000000000000000000000000000J
G000000000000000000000000000000000000000000000000000000000000000J
G000000000000000000000000000000000000000000000000000000000000000J
G000000000000000000000000000000000000000000000000000000000000000J
G000000000000000000000000000000000000000000000000000000000000000J
G000000000000000000TYYYYYYU0000000000000000000000000000000000000J
G000000000000000000G000000J0000000000000000000000000000000000000J
G000000000000000000G000P00O0000000000000000000000000000000000000J
G000000000000000000G00E000J0000000000000000000000000000000000000J
G000000000000000000BNNNNNNM0000000000000000000000000000000000000J
G000000000000000000000000000000000000000000000000000000000000000J
G000000000000000000000000000000000000000000000000000000000000000J
G000000000000000000000000000000000000000000000000000000000000000J
G000000000000000000000000000000000000000000000000TNNNNNNNNNNNNNNM
G000000000000000000000000000000000000000000000000J
G000000000000000000000000000000000000000000000000J
G000000000000000000000000000000000000000000000000J
G000000000000000000000000000000000000000000000000J
G000000000000000000000000000000000000000000000000J
G000000000000000000000000000000000000000000000000J
G000000000000000000000000000000000000000000000000J
G000000000000000000000000000000000000000000000000J
G000000000000000000000000000000000000000000000000J
G000000000000000000000000000000000000000000000000J
G000000000000000000000000000000000000000000000000J
G000000000000000000000000000000000000000000000000J
G000000000000000000000000000000000000000000000000J
G000000000000000000000000000000000000000000000000J
BNNNNNNNNNNNNNNNNNNNNNNNNNNNNNNNNNNNNNNNNNNNNNNNNM
