65
36
#################################################################
#000000000000000000000000000000000000000000000000000000000000000#
#000000000000000000000000000000000000000000000000000000000000000#
#000000000000000000000000000000000000000000000000000000000000000#
#000000000000000000000000000000000000000000000000000000000000000#
#000000000000000000000000000000000000000000000000000000000000000#
#000000000000000000000000000000000000000000000000000000000000000#
#000000000000000000000000000000000000000000000000000000000000000#
#000000000000000#######00000000000000000000000000000000000000000#
#000000000000000#0000B#00000000000000000000000000000000000000000#
#000000000000000#0B000#00000000000000000000000000000000000000000#
#000000000000000#0P000#00000000000000000000000000000000000000000#
#000000000000000#######00000000000000000000000000000000000000000#
#000000000000000000000000000000000000000000000000000000000000000#
#000000000000000000000000000000000000000000000000000000000000000#
#000000000000000000000000000000000000000000000000000000000000000#
#000000000000000000000000000000000000000000000000000000000000000#
#000000000000000000000000000000000000000000000000000000000000000#
#000000000000000000000000000000000000000000000000000000000000000#
#000000000000000000000000000000000000000000000000000000000000000#
#000000000000000000000000000000000000000000000000################
#000000000000000000000000000000000000000000000000#
#000000000000000000000000000000000000000000000000#
#000000000000000000000000000000000000000000000000#
#000000000000000000000000000000000000000000000000#
#000000000000000000000000000000000000000000000000#
#000000000000000000000000000000000000000000000000#
#000000000000000000000000000000000000000000000000#
#000000000000000000000000000000000000000000000000#
#000000000000000000000000000000000000000000000000#
#000000000000000000000000000000000000000000000000#
#000000000000000000000000000000000000000000000000#
#00000000000000000000000000000#000000000000000000#
#00000000000000000000000000000#000000000000000000#
#00000000000000000000000000000#000000000000000000#
##################################################
