65
36
#################################################################
#000000000000000000000000000000000000000000000000000000000000000#
#000000000000000000000000000000000000000000000000000000000000000#
#000000000000000000000000000000000000000000000000000000000000000#
#000000000000000000000000000000000000000CDE000000000000000000000#
#000000000000000000000000000000000000000F0H000000000000000000000#
#000000000000000000000000000000000000000F0H000000000000000000000#
#00000000000000000P0S0000000000000000000F0H000000000000000000000#
#000000000000000CDDDDDDDDE00000000000000F00DDDDDE000000000000000#
#000000000000000F0000000BH00000000000000F0000000H000000000000000#
#000000000000000F0B000000H00000000000000F000B000H000000000000000#
#000000000000000F00000000000000000000000F0000000H000000000000000#
#000000000000000F00000000000000000000000F0000000H000000000000000#
#000000000000000F00000000H00000000000000IJJJJ00JK000000000000000#
#000000000000000IJJJJJJJJK00000000000000000000000000000000000000#
#000000000000000000000000000000000000000000000000000000000000000#
#000000000000000000000000000000000000000000000000000000000000000#
#000000000000000000000000000000000000000000000000000000000000000#
#000000000000000000000000000000000000000000000000000000000000000#
#000000000000000000000000000000000000000000000000000000000000000#
#000000000000000000000000000000000000000000000000################
#000000000000000000000000000000000000000000000000#
#000000000000000000000000000000000000000000000000#
#000000000000000000000000000000000000000000000000#
#000000000000000000000000000000000000000000000000#
#000000000000000000000000000000000000000000000000#
#000000000000000000000000000000000000000000000000#
#000000000000000000000000000000000000000000000000#
#000000000000000000000000000000000000000000000000#
#000000000000000000000000000000000000000000000000#
#000000000000000000000000000000000000000000000000#
#000000000000000000000000000000000000000000000000#
#00000000000000000000000000000#000000000000000000#
#00000000000000000000000000000#000000000000000000#
#00000000000000000000000000000#000000000000000000#
##################################################
