30
20
##############################
#0000000000000000000000000000#
#0000000000000000000000000000#
#0000000000000000000000000000#
#0000000000000000000000000000#
#0000000000000000000000000000#
#0000000000000000000000000000#
#0000000000000000000000000000#
#000000000000000#######000000#
#000000000000000#00000#000000#
#000000000000000#000#0##00000#
#000000000000000#000#00#00000#
#000000000000000######0#00000#
#00000000000000000000#0#00000#
#0000000000000000000000000000#
#0000000000000000000000000000#
#0000000000000000000000000000#
#0000000000000000000000000000#
#0000000000000000000000000000#
##############################