65
36
#################################################################
#000000000000000000000000000000000000000000000000000000000000000#
#000000000000000000000000000000000000000000000000000000000000000#
#000000000000000000000000000000000000000000000000000000000000000#
#000000000000000000000000000000000000000###000000000000000000000#
#000000000000000000000000000000000000000#0#000000000000000000000#
#000000000000000000000000000000000000000#0#000000000000000000000#
#00000000000000000P0S0000000000000000000#0#000000000000000000000#
#000000000000000##########00000000000000#00######000000000000000#
#000000000000000#0000000B#00000000000000#0000000#000000000000000#
#000000000000000#0B000000#00000000000000#000B000#000000000000000#
#000000000000000#00000000000000000000000#0000000#000000000000000#
#000000000000000#00000000000000000000000#0000000#000000000000000#
#000000000000000#00000000#00000000000000#####00##000000000000000#
#000000000000000##########00000000000000000000000000000000000000#
#000000000000000000000000000000000000000000000000000000000000000#
#000000000000000000000000000000000000000000000000000000000000000#
#000000000000000000000000000000000000000000000000000000000000000#
#000000000000000000000000000000000000000000000000000000000000000#
#000000000000000000000000000000000000000000000000000000000000000#
#000000000000000000000000000000000000000000000000################
#000000000000000000000000000000000000000000000000#
#000000000000000000000000000000000000000000000000#
#000000000000000000000000000000000000000000000000#
#000000000000000000000000000000000000000000000000#
#000000000000000000000000000000000000000000000000#
#000000000000000000000000000000000000000000000000#
#000000000000000000000000000000000000000000000000#
#000000000000000000000000000000000000000000000000#
#000000000000000000000000000000000000000000000000#
#000000000000000000000000000000000000000000000000#
#000000000000000000000000000000000000000000000000#
#00000000000000000000000000000#000000000000000000#
#00000000000000000000000000000#000000000000000000#
#00000000000000000000000000000#000000000000000000#
##################################################
