50
20
##################################################
#000000000000000000000000000000000000000000000000#
#000000000000000000000000000000000000000000000000#
#000000000000000000000000000000000000000000000000#
#000000000000000000000000000000000000000000000000#
#000000000000000000000000000000000000000000000000#
#000000000000000000000000000000000000000000000000#
#000000000000000000000000000000000000000000000000#
#000000000000000#######00000000000000000000000000#
#000000000000000#00000#00000000000000000000000000#
#000000000000000#000#0##0000000000000000000000000#
#000000000000000#000#00#0000000000000000000000000#
#000000000000000######0#0000000000000000000000000#
#00000000000000000000#0#0000000000000000000000000#
#000000000000000000000000000000000000000000000000#
#000000000000000000000000000000000000000000000000#
#000000000000000000000000000000000000000000000000#
#000000000000000000000000000000000000000000000000#
#000000000000000000000000000000000000000000000000#
##################################################