65
36
#################################################################
#000000000000000000000000000000000000000000000000000000000000000#
#000000000000000000000000000000000000000000000000000000000000000#
#000000000000000000000000000000000000000000000000000000000000000#
#000000000000000000000000000000000000000000000000000000000000000#
#000000000000000000000000000000000000000000000000000000000000000#
#000000000000000000000000000000000000000000000000000000000000000#
#000000000000000000000000000000000000000000000000000000000000000#
#000000000000000#######00000000000000000000000000000000000000000#
#000000000000000#00000#00000000000000000000000000000000000000000#
#000000000000000#00B00#00000000000000000000000000000000000000000#
#000000000000000#00000#00000000000000000000000000000000000000000#
#000000000000000##000##00000000000000000000000000000000000000000#
#000000000000000000000000000000000000000000000000000000000000000#
#000000000000000000000000000000000000000000000000000000000000000#
#000000000000000000000000000000000000000000000000000000000000000#
#000000000000000000000000000000000000000000000000000000000000000#
#000000000000000000000000000################00000000000000000000#
#000000000000000000000000000#00000000000000#00000000000000000000#
#000000000000000000000000000#00000000000000#00000000000000000000#
#000000000000000000000000000############000#00000################
#0000000000000000000B000000000000000000#000#00000#
#00000000000000000000000000000000000000#000#00000#
#00000000000000000000000000000000000000#000#00000#
#00000000000000000000000000000000000000#000000000#
#00000000000000000000000000000000000000#000000B00#
#00000000000000000000000000000000000000#000000000#
#000000000000000000000000000000000000000000000000#
#000000000000000000000000000000000000000000000000#
#000000000000000000000000000000000000000000000000#
#000000000000000000000000000000000000000000000000#
#000000000000000000000000000000000000000000000000#
#000000000000000000000000000000000000000000000000#
#000000000000000000000000000000000000000000000000#
#000000000000000000000000000000000000000000000000#
##################################################