65
36
TYYYYYYYYYYYYYYYYYYYYYYYYYYYYYYYYYYYYYYYYYYYYYYYYYYYYYYYYYYYYYYYU
G000000000000000000000000000000000000000000000000000000000000000J
G000000000000000000000000000000000000000000000000000000000000000J
G000000000000000000000000000000000000000000000000000000000000000J
G00000000000S000000000000000000000000000000000000000000000000000J
G0000000S000S000000S00000000000000000000000000000000000000000000J
G0000000S000S000000000000000000000000000000000000000000000000000J
G000000YYYYYYYY0000000000000000000000000000000000000000000000000J
G000000000000000000000000000000000000000000000000000000000000000J
G000000000000000000000000000000000000000000000000000000000000000J
G000000000000000000000000000000000000000000000000000000000000000J
G000000S00000000000000000000000000000000000000000000000000000000J
G000TYYY0YYYU000000000000000000000000000000000000000000000000000J
G000G0E00000J000000000000000000000000000000000000000000000000000J
G000BNNNNNNNM0000000000000O0000000000000000000000000000000000000J
G000000000000000000000000000000000000000000000000000000000000000J
G00000000TYU0000000000000000000000000000000000000000000000000000J
G00000000G0J0000000000000000000000000000000000000000000000000000J
G00000000S0J0000000000000000000000000000000000000000000000000000J
G0000TYYYG0J0000000000000000000000000000000000000000000000000000J
G000P0000G0J0000000000000000000000000000000000000TNNNNNNNNNNNNNNM
G0000BNNNGeJ0000000000000000000000000000000000000J
G00000000BNM0000000000000000000000000000000000000J
G000000000000000000000000000000000000000000000000J
G000000000000000000000000000000000000000000000000J
G000000000000000000000000000000000000000000000000J
G000000000000000000000000000000000000000000000000J
G000000000000000000000000000000000000000000000000J
G000000000000000000000000000000000000000000000000J
G000000000000000000000000000000000000000000000000J
G000000000000000000000000000000000000000000000000J
G000000000000000000000000000000000000000000000000J
G000000000000000000000000000000000000000000000000J
G000000000000000000000000000000000000000000000000J
G000000000000000000000000000000000000000000000000J
BNNNNNNNNNNNNNNNNNNNNNNNNNNNNNNNNNNNNNNNNNNNNNNNNM
