65
36
TYYYYYYYYYYYYYYYYYYYYYYYYYYYYYYYYYYYYYYYYYYYYYYYYYYYYYYYYYYYYYYYU
G000000000000000000000000000000000000000000000000000000000000000J
G000000000000000000000000000000000000000000000000000000000000000J
G000000000000000000000000000000000000000000000000000000000000000J
G00000000000S000000000000000000000000000000000000000000000000000J
G0000000S000S000000S00000000000000000000000000000000000000000000J
G0000000S000S000000000000000000000000000000000000000000000000000J
G000000YYYYYYYY0000000000000000000000000000000000000000000000000J
G000000000000000000000000000000000000000000000000000000000000000J
G000000000000000000000000000J00000000000000000000000000000000000J
G000000000000000000000000000J00000000000000000000000000000000000J
G000000S00000000000S0S00S000J00000000000000000000000000000000000J
G000TYYY0YYYU000000TYYYYYYU0000000000000000000000000000000000000J
G000G0E00000J000000G000000J0000000000000000000000000000000000000J
G000BNNNNNNNM000000G000000O0000000000000000000000000000000000000J
G000000000000000000G00E000J0000000000000000000000000000000000000J
G00000000TYU0000000BNNNNNNM0000000000000000000000000000000000000J
G00000000G0J0000000000000000000000000000000000000000000000000000J
G00000000S0J0000000000000000000000000000000000000000000000000000J
G0000TYYYG0J0000000000000000000000000000000000000000000000000000J
G000P000EGEJ0000000000000000000000000000000000000TNNNNNNNNNNNNNNM
G0000BNNNG0J0000000000000000000000000000000000000J
G00000000BNM0000000000000000000000000000000000000J
G000000000000000000000000000000000000000000000000J
G000000000000000000000000000000000000000000000000J
G000000000000000000000000000000000000000000000000J
G000000000000000000000000000000000000000000000000J
G000000000000000000000000000000000000000000000000J
G000000000000000000000000000000000000000000000000J
G000000000000000000000000000000000000000000000000J
G000000000000000000000000000000000000000000000000J
G000000000000000000000000000000000000000000000000J
G000000000000000000000000000000000000000000000000J
G000000000000000000000000000000000000000000000000J
G000000000000000000000000000000000000000000000000J
BNNNNNNNNNNNNNNNNNNNNNNNNNNNNNNNNNNNNNNNNNNNNNNNNM
