65
36
TYYYYYYYYYYYYYYYYYYYYYYYYYYYYYYYYYYYYYYYYYYYYYYYYYYYYYYYYYYYYYYYU
G000000000000000000000000000000000000000000000000000000000000000J
G000000000000000000000000000000000000000000000000000000000000000J
G000000000000000000000000000000000000000000000000000000000000000J
G00000000000S000000000000000000000000000000000000000000000000000J
G0000000S000L000000S00000000000000000000000000000000000000000000J
G0000000S000S000000000000000000000000000000000000000000000000000J
G000000YYYYYYYY0000000000000000000000000000000000000000000000000J
G000000000000000000000000000000000000000000000000000000000000000J
G0000000000L0000000000000000000000000000000000000000000000000000J
G0000000000L0000000000000000000000000000000000000000000000000000J
G000000S000L0000000000000000000000000000000000000000000000000000J
G000TY0Y0YYYU000000000000000000000000000000000000000000000000000J
G000G0000000J000000000000000000000000000000000000000000000000000J
G000BNNNNNNNM0000000000000P0000000000000000000000000000000000000J
G00000000000000000000000DDD0000DDDDD0000000000000000000000000000J
G00000000TYU000000000000DSD0000D000D0000000000000000000000000000J
G00000000G0J000000000000DDD0000DDDDD0000000000000000000000000000J
G00000L00S0J000000000000DDD0000DDDDD0000000000000000000000000000J
G0000TYYYG0J0000000000000000000DDDDD0000000000000000000000000000J
G00P0SE00G0J0000000000000000000000000000000000000TNNNNNNNNNNNNNNM
G0000BNNNG0J0000000000000000000000000000000000000J
G00000000BNM0000000000000000000000000000000000000J
G000000000000000000000000000000000000000000000000J
G000000000000000000000000000000000000000000000000J
G000000000000000000000000000000000000000000000000J
G000000000000000000000000000000000000000000000000J
G000000000000000000000000000000000000000000000000J
G000000000000000000000000000000000000000000000000J
G000000000000000000000000000000000000000000000000J
G000000000000000000000000000000000000000000000000J
G000000000000000000000000000000000000000000000000J
G000000000000000000000000000000000000000000000000J
G000000000000000000000000000000000000000000000000J
G000000000000000000000000000000000000000000000000J
BNNNNNNNNNNNNNNNNNNNNNNNNNNNNNNNNNNNNNNNNNNNNNNNNM
